56,56,56,56,56,56,56,56,56,56,56,56
56,56,56,56,56,56,56,56,56,56,56,56
56,56,56,56,50,50,50,50,50,56,56,56
56,56,50,56,56,56,56,56,56,56,56,56
56,50,50,50,56,56,56,56,56,56,56,56
56,56,50,56,56,56,56,56,56,56,56,56
56,56,56,56,56,56,56,56,56,56,56,56
56,56,56,56,56,56,56,56,50,56,56,56
56,56,56,56,56,56,56,50,50,50,56,56
56,56,56,56,56,56,56,56,50,56,56,56
56,56,56,50,50,50,50,56,56,56,56,56
56,56,56,56,56,56,56,56,56,56,56,56
56,56,56,56,56,56,56,56,56,56,56,56