49,49,49,49,49,49,49,49
49,56,56,56,56,56,56,49
49,56,49,56,56,49,56,49
49,56,56,50,50,56,56,49
49,56,56,50,50,56,56,49
49,56,49,56,56,49,56,49
49,56,56,56,56,56,56,49
49,49,49,49,49,49,49,49